111111111111111
100P11111111111
111111111111111
