111111111111111
1000E0000000001
10000000000C001
1000P0000000001
100000000000001
111111111111111
