1111111111111111111
100C00000000000C001
100000000000P000001
1000000000000000001
1000000000000000001
100C000000000000001
1000000000000000001
1000000000000000001
1000000000000000001
1000000000000000001
1000000000000000001
100000000C000000001
1000000000000000001
10C0000000000000001
1000000000000000001
1000000000000000001
1000000E00000000001
1000000000000000001
100000000000000C001
1111111111111111111
